R 800 600
NO ./textures/Karl_Marx.xpm
SO ./textures/redbrick.xpm
WE ./textures/eagle.xpm

F 223,189,77
C 135,206,250

EA ./textures/greystone.xpm
S   ./textures/jean-luc.xpm

    1111111111111111            
1111100000000011111111111
1000000000002000000000001
1000000000000000000000001
1000000000000200000000001
1000000000000000000000001
1000000000000000000000001
1000000000000000000000001
1000000000000000000000001
1000000000000000000000001
1000000000000000000000001
1000000000000000000000001
1000000000000000000000001
1000000000000000000000001 11111111
1000000000000000000000001110000001
1000000000000000000000001110000001
1000000000000000000000001110000001
1000000000000000000000001110000001
1200000000000000000000021110000001
1111111111111110000000001110000001
              10000000001110000001
              10000000001110000001
              11111111101110000001
                      101110000001
                      100000000001
                      1N1111111111
                      111
